
NO textures/NO.xpm

SO              textures/SO.xpm
WE       textures/WE.xpm

F 120,200,   10         




EA    textures/EA.xpm

C   0,255, 255

1111111111111111111111111111    1111111111111
11000000000000000000000000011   1000000000001
100000000000000000000000000011111000000000001
100000000000000000000001000000010000000000001
100000100000000101010000000001111000000000001
100000100010000000000000000001  1000000000001
1111111000100001000100000000001 1111111111111
1111111000101000100000000000011
1111111111110000111101111111111
100000000001000100000001
10000000000010010000000111111111111111111111
10000000000001010000000000000000000000000001
10000000000000111111111111111111111111111001
10000000000000010000000100000000000000000001
10000000000000000000000101111111111111111111
10000000000000000000000100000000001
11111111100000000000000100000000001
110100001000000000000001111111111111
1100001010000000000000000100000000001
110100001000000000000001000000000001
110111111000000000000001000000000001
110000000000000000000001000000000001
110000000000000000000000000000000001
111111111111111111111111111111111111
