
    NO textures/N.xpm    
 SO textures/S.xpm   
 EA textures/E.xpm  
  WE textures/W.xpm    
 F 220,200,0   
 
 
C 225,30,0

 1111
100001   
100001   
1000N1   
 1111   