
NO textures/Goiko.xpm

SO              textures/Iker.xpm
WE       textures/canita.xpm
EA    textures/fary.xpm

C   0,0, 255
F 28, 229, 7  

111111111
100010001   
100000001 
100000001  
1100W0011  
100000001
100000001 
100010001 
1111 1111 