
    NO textures/NO.xpm    
 SO textures/SO.xpm   
 EA textures/EA.xpm  
  WE textures/WE.xpm    
 F 222,222,2   
 
 
C 222,32,2

111111
100001   
10N001   
100001   
111111  