11111111111
10000000001
10000000001
10010101001
10000000001
10000N00001
10100000101
10000001001
10000000001
10000100001
11111111111