11111111111
10000000001
10000000001
10010001001
10000000001
10000100001
10000000001
10010N01001
10000000001
10000100001
11111111111