
    NO textures/N.xpm    
 SO textures/S.xpm   
 EA textures/E.xpm  
  WE textures/W.xpm    
 F 222,222,2   
 
 
C 222,32,2

 1111
100001   
100001   
100001   
 1111   