
    NO textures/N.xpm    
 SO textures/S.xpm   
 EA textures/E.xpm  
  WE textures/W.xpm    
 F 220,200,0   
 
 
C 225,30,0

111111
100001   
1N0001   
100011   
111111   