
    NO textures/N.xpm    
 SO textures/S.xpm   
 EA textures/E.xpm  
  WE textures/W.xpm    
 F 220,200,0   
 
 
C 225,30,0

111111   
1N0011   
100011   
111111   