

NO textures/Goiko.xpm

SO            textures/Iker.xpm

WE       textures/canita.xpm

EA    textures/fary.xpm

F 28,  229, 7 

C   0,0, 255

1111111111111111111111111111   11111111111111
1100000010000000000000000011   10000000000001
10000000010000100001000000001111000000000001
10000000001000000000100000000010000000000001
10000010000000010101010000000N111000000000001
1000001000100000000000010000011 1000000000001
1111111000100001000100010000001 1111111111111
1111111000101000100000010001011
1111111111110000111101111111111
100000000001000100000001
10000000000010010000000111111111111111111111
10000000000001010000000000000000000000000001
10000000000000111111111111111111111111111001
10000000000000000000000101111111111111111111
10000000000000000000000100000000001
11111111100000000010000100000000001
110100001000000001000001111111111111
111000101000000010000001000000000001
110100001000100000000001000000000001
110111111001000000000001000000000001
110000000010000000000001000000000001
110000000100000000000000000000000001
111111111111111111111111111111111111
