
   SO              textures/Iker.xpm
      WE       textures/canita.xpm
EA    textures/fary.xpm


C   0,0, 255
NO textures/Goiko.xpm      
F 28, 229, 7     


 1111111111111111111111111111    1111111111111 
 110000000100000010000100000011  1100000000001
 10000100000000000000000000001111000000000001
 100000000000000100000001000000010000000000001
  100000100000000101010000000001111000000000001
 100000100010000000000000000001  1000000000001
 1111111000100001000100000000001 1111111111111
 1111111000101000100000000000011
 1111111111110000111101111111111
110000000001000100000001
10000000000000010000000111111111111111111111
10000000000000010000000000000000000000000001
10100000000000111111111111111111111111111001
10000000000000010000000100000000000000000001
10000000000000000010000101111111111111111111
10000000000000000000000100000000001
11111111100000000000000100000000001
110100001000000000000001111111111111
111000101000000000000001000001000001
1101000010000000S00000010100001000001
110111111000000000100001000000000001
110000000100000010001001000000000001
110000000000100000001000001001000001
111111111111111111111111111111111111

