111111111111111111111111111
100000000000000000000000001
100000000000000000000000001
100000000000000000000000001
100000000000000000000000001
100000000000000000000000001
100000000000000000000000001
100000000000000000000000001
100000000000000000000000001
100000000000000000000000001
100000000000000010000000001
100000000000000000000000001
100000000000000000000000001
100000000000000000000000001
100000000000000000010000001
100000000000000000000000001
100000000000000000000000001
10000000000000N000000000001
111111111111111111111111111