111111111111111111111111111
100000001000000100000000001
100000000000000010000000001
100000000010101000000100001
100000000000000000000000001
100000000000000000000001001
100000001000000000100000101
100000000001100010000000001
100000000000000000010000001
1000000000000N0000000000001
111111111111111111111111111